14 14 14 14 14 14 14 14 14 14 14 14 14 14 14 14 14 14 14 14 14 14 14 14 14 14 14 14 14 14 14 14 14 14 14 14 14 14 14 14 14 14 14 14 14 14 14 14 14 14 14 14 14 14 14 14 14 14 14 14 14 14
14 14 14 14 14 14 14 14 14 14 14 14 14 14 14 14 14 14 14 14 14 14 14 14 14 14 14 14 14 14 14 14 14 14 14 14 14 14 14 14 14 14 14 14 14 14 14 14 14 14 14 14 14 14 14 14 14 14 14 14 14 14
14 14 14 14 14 14 14 14 14 14 14 14 14 14 14 14 14 14 14 14 14 14 14 14 14 14 14 14 14 14 14 14 14 14 14 14 14 14 14 14 14 14 14 14 14 14 14 14 14 14 14 14 14 14 14 14 14 14 14 14 14 14
14 14 14 14 14 14 14 14 14 14 14 14 14 14 14 14 14 14 14 14 14 14 14 14 14 14 14 14 14 14 14 14 14 14 14 14 14 14 14 14 14 14 14 14 14 14 14 14 14 14 14 14 14 14 14 14 14 14 14 14 14 14
14 14 14 14 14 14 14 14 14 14 14 14 14 14 14 14 14 14 14 14 14 14 14 14 14 14 14 14 14 14 14 14 14 14 14 14 14 14 14 14 14 14 14 14 14 14 14 14 14 14 14 14 14 14 14 14 14 14 14 14 14 14
14 14 14 14 14 14 14 1 1 1 1 1 1 1 1 1 1 1 1 1 1 1 1 1 1 1 1 1 1 1 1 1 1 1 1 1 1 1 1 1 8 8 8 8 8 8 8 8 8 8 8 8 8 8 8 14 14 14 14 14 14 14
14 14 14 14 14 14 14 1 4 15 15 4 4 0 0 0 0 4 4 4 4 4 0 0 0 0 0 4 4 0 0 0 15 15 15 4 4 4 4 4 16 2 2 2 2 2 2 16 16 16 16 6 6 6 8 14 14 14 14 14 14 14
14 14 14 14 14 14 14 1 0 0 0 15 15 0 0 0 0 4 15 15 15 0 0 0 0 0 0 15 0 0 0 0 0 0 0 4 0 0 0 4 16 2 2 2 2 2 2 16 16 16 16 16 7 6 8 14 14 14 14 14 14 14
14 14 14 14 14 14 14 1 0 0 0 0 0 0 0 0 0 0 0 0 0 0 0 0 0 0 0 0 0 0 0 0 0 0 0 4 0 0 0 4 16 16 2 2 2 2 2 2 2 2 2 2 2 2 8 14 14 14 14 14 14 14
14 14 14 14 14 14 14 1 0 0 0 0 0 0 0 0 0 0 0 0 0 0 0 0 0 0 0 0 0 0 0 0 0 0 0 0 0 0 0 4 2 6 6 6 6 2 2 2 2 2 2 2 2 2 8 14 14 14 14 14 14 14
14 14 14 14 14 14 14 1 0 0 0 0 0 0 0 0 0 0 0 0 0 0 0 0 0 0 0 0 0 0 0 0 0 0 0 0 0 3 3 3 5 5 2 2 6 2 2 2 2 2 2 2 2 2 8 14 14 14 14 14 14 14
14 14 14 14 14 14 14 1 15 0 0 0 0 4 0 0 0 0 0 0 0 0 0 0 0 0 0 0 0 0 0 0 0 0 0 0 0 3 3 3 5 5 2 2 6 2 2 16 7 16 2 2 2 2 8 14 14 14 14 14 14 14
14 14 14 14 14 14 14 1 15 4 4 4 15 4 0 0 0 0 0 0 0 0 0 0 0 0 0 0 0 0 0 0 0 0 0 0 0 0 0 4 2 2 2 6 6 2 2 2 2 2 2 2 2 2 8 14 14 14 14 14 14 14
14 14 14 14 14 14 14 1 0 0 0 0 0 0 0 0 0 0 0 0 0 0 0 0 0 0 0 0 0 0 0 0 0 0 0 0 0 0 0 4 2 2 2 2 2 2 2 2 2 2 2 2 2 2 8 14 14 14 14 14 14 14
14 14 14 14 14 14 14 1 0 0 0 0 0 0 0 0 15 15 15 0 0 0 0 0 0 15 0 0 0 0 0 0 15 15 3 3 0 0 0 4 2 2 2 2 2 2 2 16 16 16 2 2 2 2 8 14 14 14 14 14 14 14
14 14 14 14 14 14 14 1 0 0 0 0 0 4 4 0 4 4 4 0 0 0 0 0 0 15 0 0 0 0 0 0 0 15 3 3 0 0 0 4 2 2 2 2 2 2 16 16 16 16 16 16 16 16 8 14 14 14 14 14 14 14
14 14 14 14 14 14 14 1 15 15 0 0 0 0 4 4 4 4 0 0 0 0 0 4 4 4 4 4 4 4 4 4 4 4 3 3 4 4 4 4 6 2 2 2 2 2 2 2 2 16 16 16 2 2 8 14 14 14 14 14 14 14
14 14 14 14 14 14 14 1 0 0 0 0 0 0 0 0 0 4 0 0 0 4 15 4 6 6 16 16 16 2 2 2 2 2 5 5 2 2 2 6 6 16 16 2 2 2 2 2 2 2 2 2 2 2 8 14 14 14 14 14 14 14
14 14 14 14 14 14 14 1 4 4 4 4 0 0 0 0 0 4 0 0 0 4 15 4 6 16 2 2 16 2 2 2 2 2 5 5 2 2 2 2 2 2 16 16 2 2 2 2 2 2 2 2 2 16 8 14 14 14 14 14 14 14
14 14 14 14 14 14 14 1 15 15 15 4 4 4 0 0 0 4 0 0 0 3 3 3 5 5 2 2 16 2 2 2 2 2 5 5 2 2 2 2 2 2 2 2 2 2 2 2 2 2 2 2 2 16 8 14 14 14 14 14 14 14
14 14 14 14 14 14 14 1 0 0 0 0 15 4 0 0 0 4 0 0 0 3 3 3 5 5 2 2 2 2 2 2 2 2 2 2 16 16 2 2 2 2 2 2 2 2 2 2 2 2 16 16 16 16 8 14 14 14 14 14 14 14
14 14 14 14 14 14 14 1 0 0 0 0 0 0 0 0 0 4 4 4 0 0 0 4 6 2 2 2 2 2 2 2 2 2 2 16 16 16 16 2 2 2 2 2 2 16 2 2 2 2 2 16 16 2 8 14 14 14 14 14 14 14
14 14 14 14 14 14 14 1 0 0 0 0 0 0 0 0 0 0 0 0 0 0 0 4 6 2 2 2 2 2 2 2 2 2 2 2 2 2 2 2 2 2 2 2 2 2 2 16 2 2 2 2 2 2 8 14 14 14 14 14 14 14
14 14 14 14 14 14 14 1 4 4 4 4 0 0 0 0 0 0 0 0 0 0 0 4 2 2 2 2 2 2 2 2 2 2 2 2 2 2 2 2 2 2 2 2 2 16 16 16 16 2 2 2 2 2 8 14 14 14 14 14 14 14
14 14 14 14 14 14 14 1 4 4 0 0 0 0 0 0 0 0 0 0 0 0 0 4 16 2 2 2 2 2 2 2 2 2 2 2 2 2 2 2 2 2 2 2 2 2 2 16 2 2 2 2 2 2 8 14 14 14 14 14 14 14
14 14 14 14 14 14 14 1 4 0 0 0 0 0 0 0 0 0 0 15 15 0 0 4 16 2 2 2 2 2 2 2 2 2 2 2 2 2 2 2 2 2 2 2 2 2 2 2 16 2 2 2 2 2 8 14 14 14 14 14 14 14
14 14 14 14 14 14 14 1 4 4 4 4 0 0 0 0 0 0 0 0 15 0 15 4 16 2 2 2 2 2 2 2 2 5 5 2 2 16 16 2 2 2 2 2 2 2 2 5 5 2 2 2 2 2 8 14 14 14 14 14 14 14
14 14 14 14 14 14 14 1 0 0 0 0 0 0 0 0 0 0 0 0 15 15 15 4 16 16 16 2 2 2 2 2 2 2 16 16 16 16 16 2 2 2 2 2 2 2 2 2 2 2 16 16 16 6 8 14 14 14 14 14 14 14
14 14 14 14 14 14 14 1 4 4 4 4 15 15 15 15 15 15 4 4 4 4 4 4 6 6 6 6 6 6 6 6 6 6 6 6 6 6 6 6 6 6 6 6 6 6 6 6 6 6 6 6 6 6 8 14 14 14 14 14 14 14
14 14 14 14 14 14 14 10 13 13 13 12 9 13 13 11 11 13 13 9 9 18 18 18 18 9 9 9 9 13 9 9 13 11 11 13 9 18 18 18 9 9 17 9 9 13 13 11 11 13 13 13 13 13 10 14 14 14 14 14 14 14
14 14 14 14 14 14 14 10 13 13 12 9 9 9 13 9 9 13 9 9 9 9 9 9 9 18 18 9 9 9 9 9 13 9 9 13 9 9 9 9 9 9 17 9 9 9 13 9 9 9 9 12 12 13 10 14 14 14 14 14 14 14
14 14 14 14 14 14 14 10 13 12 9 9 9 9 9 9 9 9 9 9 9 9 9 9 9 9 9 9 9 9 9 13 9 9 9 9 13 9 9 9 9 9 9 17 9 9 9 9 9 9 9 9 12 12 10 14 14 14 14 14 14 14
14 14 14 14 14 14 14 10 12 9 9 9 9 9 9 9 9 9 9 9 9 9 9 9 9 9 9 9 9 9 9 13 9 9 9 9 13 9 9 9 9 9 9 17 9 9 9 9 9 9 9 9 9 9 10 14 14 14 14 14 14 14
14 14 14 14 14 14 14 10 9 9 9 9 9 9 9 9 9 9 9 9 9 9 9 9 9 9 9 9 9 9 9 9 9 9 9 9 9 9 9 9 9 9 17 17 17 17 17 17 9 9 9 9 9 9 10 14 14 14 14 14 14 14
14 14 14 14 14 14 14 10 17 17 17 9 9 9 9 9 9 12 13 9 9 9 9 9 9 9 9 9 9 9 9 9 9 9 9 9 9 9 9 9 9 9 9 9 9 9 12 17 9 9 9 9 9 9 10 14 14 14 14 14 14 14
14 14 14 14 14 14 14 10 17 18 18 9 9 9 9 9 13 13 13 12 9 9 9 9 9 9 9 9 9 9 9 9 9 9 9 9 9 9 9 9 9 9 9 9 9 9 12 12 9 9 9 9 9 9 10 14 14 14 14 14 14 14
14 14 14 14 14 14 14 10 17 17 18 9 9 9 9 9 13 9 13 9 9 9 9 9 9 9 9 9 9 9 9 9 9 9 9 9 9 9 9 9 9 9 9 9 9 9 9 9 12 9 9 9 9 9 10 14 14 14 14 14 14 14
14 14 14 14 14 14 14 10 12 9 9 9 9 9 9 9 13 9 13 9 9 9 9 9 9 9 9 9 9 9 9 9 9 9 9 9 9 9 13 18 9 9 9 9 9 9 9 9 9 9 9 9 9 12 10 14 14 14 14 14 14 14
14 14 14 14 14 14 14 10 13 12 9 9 9 9 9 9 9 9 13 9 9 9 9 9 9 9 9 17 17 9 9 9 9 9 9 9 9 13 13 13 18 9 9 9 9 9 9 9 9 18 9 9 17 12 10 14 14 14 14 14 14 14
14 14 14 14 14 14 14 10 13 13 12 9 9 9 9 9 9 9 13 9 9 9 9 9 18 17 17 17 18 9 9 9 9 9 9 9 9 9 13 13 18 9 9 9 9 9 18 18 9 9 17 17 12 12 10 14 14 14 14 14 14 14
14 14 14 14 14 14 14 10 13 13 13 13 13 13 13 13 13 13 13 13 13 13 13 13 13 13 13 13 13 13 13 13 13 13 13 13 13 13 13 13 13 13 13 13 13 13 13 13 13 13 13 13 13 13 10
14 14 14 14 14 14 14 14 14 14 14 14 14 14 14 14 14 14 14 14 14 14 14 14 14 14 14 14 14 14 14 14 14 14 14 14 14 14 14 14 14 14 14 14 14 14 14 14 14 14 14 14 14 14 14 14 14 14 14 14 14 14
14 14 14 14 14 14 14 14 14 14 14 14 14 14 14 14 14 14 14 14 14 14 14 14 14 14 14 14 14 14 14 14 14 14 14 14 14 14 14 14 14 14 14 14 14 14 14 14 14 14 14 14 14 14 14 14 14 14 14 14 14 14
14 14 14 14 14 14 14 14 14 14 14 14 14 14 14 14 14 14 14 14 14 14 14 14 14 14 14 14 14 14 14 14 14 14 14 14 14 14 14 14 14 14 14 14 14 14 14 14 14 14 14 14 14 14 14 14 14 14 14 14 14 14
14 14 14 14 14 14 14 14 14 14 14 14 14 14 14 14 14 14 14 14 14 14 14 14 14 14 14 14 14 14 14 14 14 14 14 14 14 14 14 14 14 14 14 14 14 14 14 14 14 14 14 14 14 14 14 14 14 14 14 14 14 14
14 14 14 14 14 14 14 14 14 14 14 14 14 14 14 14 14 14 14 14 14 14 14 14 14 14 14 14 14 14 14 14 14 14 14 14 14 14 14 14 14 14 14 14 14 14 14 14 14 14 14 14 14 14 14